############################################################
#      ##       --       ##           ##           ##      #
#      --       ##       ##           ##           ##      #
#      ##       ##       --           ##           --      #
#      ##       ##       ##           --           ##      #
#      ##       ##       ##           ##           ##      #
#      ##       ##       ##           ##           ##      #
######|##       ##       ##           ##           ##      #
######|##       ##       ##           ##           ##      #
#      ##       --       ##           ##           ##      #
#      --       ##       ##           --           ##      #
#      ##       ##       ##           ##           --      #
#      ##       ##       --           ##           ##      #
#      ##       ##       ##########|######|##########      #
#      ##       ##       ##########|######|###########|#####
#      #######|#####|###|##         ##             ###|#####
#      #######|#####|###|##         ##             ##      #
#      ##      --        ##         --             ##      #
#      ##      ##        ##         ##             ##      #
#      --      ##        ##         ##             --      #
#      ##      ##        ##         ##             ##      #
#      ##      ##        --         ##             ##      #
#      ##      ##        ##         ##             ##|######
###|#####      ##        ####|########             ##|######
###|#########|#######|##|####|############|##########      #
#      ######|#######|##|##         ######|##########      #
#      ##        --      ##         ##             --      #
#      ##        ##      ##         ##             ##      #
#      --        ##      --         --             ##      #
#      ##        ##      ##         ##             ##      #
#      ##        ##      ##         ##             ##|######
#      ##        ##      ##         ##             ##|######
#      ####|#########|##|#######|#############|######      #
#      ####|#########|##|#######|#############|######      #
#      ##             --            ##             ##      #
#      ##             ##            --             ##      #
#      --             ##            ##             ##      #
#      ##             ##            ##             ##      #
#      ##             ##            ##             --      #
######|##             ##            ##             ##|######
######|##             ##            ##             ##|######
#      #####|#######|###|###|#############|##########      #
#      #####|#######|###|###|#############|##########      #
#      ##             --            ##             ##      #
#      ##             ##            ##             ##      #
#      ##             ##            ##             ##      #
#      ##             ##            ##             ##      #
#      ##             ##            --             --      #
#      --             ##            ##             ##      #
############################################################