||||||||||||||||||||||||||||||||||||||||||||||||||||||||||||
|                    ||           ||                       |
|                    ||           ||                       |
|                    ||           ||                       |
|||||||||||||||||||||||           ||                       |
|||||||||||||||||||||||           ||                       |
|                    ||           ||                       |
|                    ||           ||                       |
|                    |||||||||||||||                       |
|                    |||||||||||||||                       |
|||||||||||||||||||||||           ||||||||||||||||||||||||||
|||||||||||||||||||||||           ||||||||||||||||||||||||||
|                    ||           ||                       |
|                    ||           ||                       |
|                    ||           ||                       |
|                    ||           ||                       |
|                    ||           ||                       |
|                    ||           ||                       |
|                    ||           ||                       |
|                    ||           ||                       |
|                    ||           ||                       |
|                    ||           ||                       |
|                    ||           ||                       |
|                    ||           ||                       |
|                    ||           ||                       |
|                    ||           ||                       |
|                    ||           ||                       |
|                    ||           ||                       |
|                    ||           ||                       |
|                    ||           ||                       |
|                    ||           ||                       |
|                    ||           ||                       |
||||||||||||||||||||||||||||||||||||||||||||||||||||||||||||
