                                                            
                                                            
  ###########    ###########    ###########    ###########  
  #.........#    #.........#    #.........#    #.........#  
  #.........#    #.........#    #.........#    #.........#  
  #.........#    #.........#    #.........#    #.........#  
  #.........#    #.........#    #.........#    ###########  
  #.........#    #.........#    #.........#        #|#      
  #.........#    #.........#    #.........#        #|#      
  #.........#    #.........#    #.........#        #|#      
  ###########    #.........#    #.........#        #|#      
      #|#        #.........#    #.........#    ###########  
      #|#        #.........#    #.........#    #.........#  
      #|#        #.........#    #.........#    #.........#  
      #|#        #.........#    #.........#    #.........#  
  ###########    #.........#    #.........#    #.........#  
  #.........#    #.........#    #.........#    #.........#  
  #.........#    #.........#    #.........#    #.........#  
  #.........#    #.........#    ###########    #.........#  
  #.........#    #.........#        #|#        #.........#  
  #.........#    #.........#        #|#        ###########  
  #.........#    #.........#        #|#            #|#      
  #.........#    #.........#        #|#            #|#      
  #.........#    ###########    ###########        #|#      
  #.........#        #|#        #.........#        #|#      
  #.........#        #|#        #.........#    ###########  
  #.........#        #|#        #.........#    #.........#  
  #.........#        #|#        #.........#    #.........#  
  #.........#    ###########    #.........#    #.........#  
  #.........######.........######.........######.........#  
  #.........#----#.........#----#.........#----#.........#  
  #.........######.........######.........######.........#  
  #.........#    #.........#    #.........#    #.........#  
  #.........#    #.........#    #.........#    #.........#  
  #.........#    ###########    #.........#    #.........#  
  #.........#        #|#        #.........#    #.........#  
  #.........#        #|#        #.........#    #.........#  
  ###########        #|#        #.........#    ###########  
      #|#            #|#        #.........#        #|#      
      #|#        ###########    #.........#        #|#      
      #|#        #.........#    #.........#        #|#      
      #|#        #.........#    #.........#        #|#      
  ###########    #.........#    #.........#    ###########  
  #.........#    #.........#    #.........#    #.........#  
  #.........#    #.........#    #.........#    #.........#  
  #.........#    #.........#    #.........#    #.........#  
  #.........#    #.........#    #.........#    #.........#  
  #.........#    #.........#    ###########    #.........#  
  #.........#    #.........#        #|#        #.........#  
  #.........#    #.........#        #|#        #.........#  
  #.........#    #.........#        #|#        #.........#  
  #.........#    #.........#        #|#        #.........#  
  #.........#    #.........#    ###########    #.........#  
  #.........#    #.........#    #.........#    #.........#  
  #.........#    #.........#    #.........#    #.........#  
  #.........#    #.........#    #.........#    #.........#  
  #.........#    #.........#    #.........#    #.........#  
  ###########    ###########    ###########    ###########  
                                                            
                                                            
