                                                            
 ########   ###########   ######   ########   ############# 
 #......#   #.........#   #....#   #......#   #...........# 
 #......#   #.........#   #....#   #......#   #...........# 
 #......#   #.........#   #....#   #......#   #...........# 
 #......#   #.........#   #....#   #......#   #...........# 
 #......#   #.........#   #....#   #......#   #...........# 
 #......#   #.........#   #....#   #......#   #...........# 
 #......#   #.........#   #....#   #......#   #...........# 
 #......#   #.........#   #....#   #......#   #...........# 
 #......#   #.........#   #....#   #......#   #...........# 
 #......#   #.........#   #....#   #......#   #...........# 
 ########   ###########   ######   ########   ############# 
                                                            
                                                            
                                                            
 #############   ############   ##########   ############## 
 #...........#   #..........#   #........#   #............# 
 #...........#   #..........#   #........#   #............# 
 #...........#   #..........#   #........#   #............# 
 #...........#   #..........#   #........#   #............# 
 #...........#   #..........#   #........#   #............# 
 #############   ############   ##########   ############## 
                                                            
                                                            
                                                            
 #############   ################   ######   ######   ##### 
 #...........#   #..............#   #....#   #....#   #...# 
 #...........#   #..............#   #....#   #....#   #...# 
 #...........#   #..............#   #....#   #....#   #...# 
 #...........#   #..............#   #....#   #....#   #...# 
 #############   ################   ######   ######   ##### 
                                                            
                                                            
                                                            
 #############   ########   #########   ########   ######## 
 #...........#   #......#   #.......#   #......#   #......# 
 #...........#   #......#   #.......#   #......#   #......# 
 #...........#   #......#   #.......#   #......#   #......# 
 #...........#   #......#   #.......#   #......#   #......# 
 #...........#   #......#   #.......#   #......#   #......# 
 #...........#   #......#   #.......#   #......#   #......# 
 #############   ########   #########   ########   ######## 
                                                            
                                                            
                                                            
 ########   #####   #################   ########   ######## 
 #......#   #...#   #...............#   #......#   #......# 
 #......#   #...#   #...............#   #......#   #......# 
 #......#   #...#   #...............#   #......#   #......# 
 ########   #####   #################   ########   ######## 
                                                            
                                                            
                                                            
 ##########   ######   ############   ###########   ####### 
 #........#   #....#   #..........#   #.........#   #.....# 
 #........#   #....#   #..........#   #.........#   #.....# 
 #........#   #....#   #..........#   #.........#   #.....# 
 ##########   ######   ############   ###########   ####### 
                                                            
