##################################################
#      ##         ##          ##         ##      #
#      ##         ##          ##         ##      #
#      ##         ##          ##         ##      #
#      ##         ##          ##         ##      #
#      ##         ##          ##         ##      #
#      ##         ##          ##         ##      #
#      ##         ##          ##         ####-####
#-#######         ##          ##         ####-####
#-#######-####-##-###-#######-##-######-###      #
#      ##-####-##-###-#######-##-######-###      #
#      ##         ##          ##         ##      #
#      ##         ##          ##         ##      #
#      ##         ##          ##         ##      #
#      ##         ##          ##         ##      #
#      ##         ##          ##         ##      #
#      ##         ##          ##         ##      #
#      ##         ##          ##         ##      #
######-##-##-####-##-#####-#####         #######-#
######-##-##-####-##-#####-#####-######-########-#
#         ##          ##      ##-######-###      #
#         ##          ##      ##         ##      #
#         ##          ##      ##         ##      #
#         ##          ##      ##         ##      #
#         ##          ##      ##         ##      #
#         ##          ##      ##         ##      #
#         ##          ##      ##         ##      #
#         ##          ##      ##         ##      #
#         ##          ##      ##         ##      #
#         ##          ##      ##         ##      #
#         ##          ##      ##         ##      #
#         ##          ##      ##         ##      #
#         ##          ##      ##         ##      #
#         ##          ##      ##         ##      #
##-######-####-##-##-########-###-#####-######-###
##-######-####-##-##-########-###-#####-######-###
#              ##       ##           ##          #
#              ##       ##           ##          #
#              ##       ##           ##          #
#              ##       ##           ##          #
#              ##       ##           ##          #
#              ##       ##           ##          #
#              ##       ##           ##          #
#              ##       ##           ##          #
#              ##       ##           ##          #
#-#######-####-##       ##           ##          #
#-#######-####-##       ##           ##-###-######
#              ##       ##           ##-###-######
#              ##       ##           ##          #
#              ##-##-########-######-##          #
#              ##-##-########-######-##          #
#              ##      ##            ##          #
#              ##      ##            ##          #
#              ##      ##            ##          #
#              ##      ##            ##          #
#              ##      ##            ##          #
#              ##      ##            ##          #
#              ##      ##            ##          #
#              ##      ##            ##          #
##################################################
