#%%%%%%%%%%%%%%%###%%%######################%%%%%%%%%%%%%%##
#                ##            %%         ##               #
#                ##            %%         ##               #
#                ##            %%         ##               #
#                ##            %%         ##               #
#                ##            %%         ##               #
#                ##            %%         ##               #
#                ##            %%         ##               #
#                ##            %%         ##################
#                ##            %%         ##################
###################            %%         ##               #
###################            %%         ##               #
#                %%            %%         ##               #
#                %%            %%         ##               #
#                %%            %%         ##               #
#                %%            %%         ##               #
#                %%            %%         ##%%%%%%%%%%%%%%##
#                %%            %%         ##%%%%%%%%%%%%%%##
#                ##            ##         ##               #
#%%%%%%%%%%%###%%%%%%%######################               #
#%%%%%%%%%%%###%%%%%%%######################               #
#            %%        %%        %%       ##               #
#            %%        %%        %%       ##               #
#            %%        %%        %%       ##               #
#            %%        %%        %%       ##               #
#            %%        %%        %%       ##               #
#            %%        %%        %%       ##               #
#            %%        %%        %%       ##               #
#            %%        %%        %%       ##               #
#            %%        %%        %%       ##               #
#            %%        %%        %%       ##%%%%%%%%%%%%%%##
#            %%        %%        %%       ##%%%%%%%%%%%%%%##
#            %%        %%        %%       %%               #
#            %%        %%        %%       %%               #
#            %%        %%        %%       %%               #
#            %%        %%        %%       %%               #
#            %%        %%        %%       %%               #
#            ##        ##        ##       ##               #
#            ###############################               #
#            ###############################               #
###############          %%               ##################
###############          %%               ##################
#            ##          %%               ##               #
#            ##          %%               ##               #
#            ##          %%               ##               #
#            ##          %%               ##               #
#            ##          %%               ##               #
#            ##          %%               ##               #
#            ##          ##               ##               #
#%%%%%%%%%%%%%%%###%%%######################%%%%%%%%%%%%%%##