                                                            
 #############   ########   ###########   ################# 
 #...........#   #......#   #.........#   #...............# 
 #...........#   #......#   #.........#   #...............# 
 #...........#   #......#   #.........#   #...............# 
 #...........#   #......#   #.........#   #...............# 
 #...........#   ########   #.........#   #...............# 
 #...........#              #.........#   #...............# 
 #...........#              #.........#   #...............# 
 #...........#              #.........#   #...............# 
 #...........#   ########   ###########   #...............# 
 #...........#   #......#                 #...............# 
 #...........#   #......#                 ################# 
 #...........#   #......#                                   
 #...........#   #......#   ###########                     
 #...........#   ########   #.........#                     
 #...........#              #.........#   ########   ###### 
 #...........#              #.........#   #......#   #....# 
 #...........#              #.........#   #......#   #....# 
 #...........#   ########   #.........#   #......#   #....# 
 #############   #......#   #.........#   #......#   #....# 
                 #......#   #.........#   ########   #....# 
                 #......#   #.........#              #....# 
                 #......#   #.........#              #....# 
 #############   #......#   ###########              #....# 
 #...........#   ########                 ########   #....# 
 #...........#                            #......#   #....# 
 #...........#                            #......#   ###### 
 #...........#              ###########   #......#          
 #...........#   ########   #.........#   #......#          
 #...........#   #......#   #.........#   #......#          
 #...........#   #......#   #.........#   #......#   ###### 
 #...........#   #......#   #.........#   #......#   #....# 
 #...........#   #......#   #.........#   #......#   #....# 
 #...........#   #......#   #.........#   #......#   #....# 
 #...........#   #......#   ###########   #......#   #....# 
 #...........#   #......#                 ########   ###### 
 #...........#   #......#                                   
 #...........#   #......#                                   
 #...........#   #......#   ###########                     
 #...........#   #......#   #.........#   ########   ###### 
 #...........#   ########   #.........#   #......#   #....# 
 #...........#              #.........#   #......#   #....# 
 #...........#              #.........#   #......#   #....# 
 #...........#              ###########   #......#   #....# 
 #...........#   ########                 #......#   #....# 
 #...........#   #......#                 ########   ###### 
 #...........#   #......#                                   
 #...........#   #......#   ###########                     
 #...........#   #......#   #.........#                     
 #...........#   ########   #.........#   ########   ###### 
 #...........#              #.........#   #......#   #....# 
 #...........#              #.........#   #......#   #....# 
 #...........#              #.........#   #......#   #....# 
 #...........#   ########   #.........#   #......#   #....# 
 #...........#   #......#   #.........#   #......#   #....# 
 #...........#   #......#   #.........#   #......#   #....# 
 #...........#   #......#   #.........#   #......#   #....# 
 #############   ########   ###########   ########   ###### 
                                                            
