                                                            
 ######  ########  #######  ######  ######  #######  ###### 
 #    #  #      #  #     #  #    #  #    #  #     #  #    # 
 #    #  #      #  #     #  #    #  #    ----     ----    # 
 #    #  #      #  #     #  #    #  #    ----     ----    # 
 #    ----      ----     ----    #  #    ----     ----    # 
 #    ----      |||-     ----    #  #    #  #     #  #    # 
 #    ----      |||-     ----    #  ######  ##|||##  ###### 
 #    #  #      |||#     #  #    #            |||           
 #    #  #      |||#     #  #    #            |||           
 ######  #######|||#######  ######  ##########||| ######### 
                |||                 #          || #       # 
                |||                 #          || #       # 
 ##########  ###|||  #############  #          || #       # 
 #        #  #    |  #           #  #          || #       # 
 #        #  #    |  #           #  #          || #       # 
 #        #  #    |  #           #  #####|||##||| #       # 
 #        #  #    |  #           #       |||--|||----|||### 
 #        #  #    |---           #       |||--|||----|||    
 #        #  #    |---           #  #####|||--|||----|||    
 #        #  #    |---           #  #          || ###|||### 
 #        #  #    |  #           #  #          || #       # 
 #        #  #    |  #           #  #          || #       # 
 #        #  #    |  #           #  #          || #       # 
 #        #  ###|||---|||------------          || #       # 
 ####|||--------|||---|||---------------------||| ######### 
     |||--------|||---|||---------------------|||           
     |||--------|||---|||#########            |||           
 ####|||###  #      # ||         #  ######  ##|||##  ###### 
 #        #  #      # ||         #  #    #  #     #  #    # 
 #        #  #      # ||         #  #    #  #     #  #    # 
 #        #  #      # ||         #  #    ----     ----    # 
 #        #  #      --||         #  #    ----     ----    # 
 #        #  #      ----         #  #    ----     ----    # 
 #        #  #      ----         #  #    #  #     #  #    # 
 #        #  #      #  #         #  #    #  #     #  #    # 
 #        #  #      #  #         #  ######  ##|||##  ###### 
 #        #  #      #  #         #            |||           
 #        #  #      #  #         #            |||           
 ##########  ###|||##  ###########  ########  |||########## 
                |||                 #      #  |           # 
                |||                 #      #  |           # 
 ######  #######|||######  #######  #      #  |           # 
 #    #  #     #|||     #  #     #  #      ---|           # 
 #    ----     -|||     ----     #  #      ----           # 
 #    ----     ----     ----     #  #      ----           # 
 #    ----     ----     ----     #  #      #  #           # 
 #    #  #     #  #     #  #     #  #      #  #           # 
 ######  #######  #######  #######  ########  ############# 
                                                            