                                                            
 ###########   ##########   #####   #########   ########### 
 #.........# | #........# | #...#   #.......# | #.........# 
 #.........# | #........# | #...#   #.......# | #.........# 
 #.........# | #........# | #...#   #.......# | #.........# 
 #.........# | #........# | #...#   #.......# | #.........# 
 #.........# | #........# | #...#   #.......# | #.........# 
 #.........# | #........# | #...#   #.......# | #.........# 
 #.........# | #........# | #...#   #.......# | #.........# 
 #.........# | #........# | #...#   #.......# | #.........# 
 #.........# | #........# | #...#   #.......# | #.........# 
 #||||||||.# | #........# | #...#   #|||||||# | #.........# 
 ###########   ##########   #####   #########   ########### 
                                                            
                                                            
                                                            
 ##########   ###########   #####   ###########   ######### 
 #........# | #.........# | #...# | #.........# | #.......# 
 #........# | #.........# | #...# | #.........# | #.......# 
 #........# | #.........# | #...# | #.........# | #.......# 
 #........# | #.........# | #...# | #.........# | #.......# 
 #........# | #.........# | #...# | #.........# | #.......# 
 #........# | #.........# | #...# | #.........# | #.......# 
 #........# | #.........# | #...# | #.........# | #.......# 
 #........# | #.........# | #...# | #.........# | #.......# 
 #........# | #.........# | #...# | #.........# | #.......# 
 #||||||..# | #.........# | #...# | #.........# | #.......# 
 ##########   ###########   #####   ###########   ######### 
                                                            
                                                            
                                                            
 ########   ##########   #############   #########   ###### 
 #......# | #........# | #...........# | #.......# | #....# 
 #......# | #........# | #...........# | #.......# | #....# 
 #......# | #........# | #...........# | #.......# | #....# 
 #......# | #........# | #...........# | #.......# | #....# 
 #......# | #........# | #...........# | #.......# | #....# 
 #......# | #........# | #...........# | #.......# | #....# 
 #......# | #........# | #...........# | #.......# | #....# 
 #......# | #........# | #...........# | #.......# | #||||# 
 ########   ##########   #############   #########   ###### 
                                                            
                                                            
                                                            
 #########   #######   #####   ######   ########   ######## 
 #.......# | #.....#   #...# | #....# | #......# | #......# 
 #.......# | #.....#   #...# | #....# | #......# | #......# 
 #.......# | #.....#   #...# | #....# | #......# | #......# 
 #|||||||# | #|||||#   #|||# | #||||# | #||||||# | #......# 
 #########   #######   #####   ######   ########   #||||||# 
                                                   ######## 
                                                            
                                                            
 #########   #######   #####   ######   ########            
 #.......#   #.....# | #...#   #....#   #......#   ######## 
 #.......#   #.....# | #...#   #....#   #......#   #......# 
 #.......#   #.....# | #...#   #....#   #......#   #......# 
 #.......#   #.....# | #...#   #....#   #......#   #......# 
 #########   #######   #####   ######   ########   ######## 
                                                            
