                                                            
 ##################################  #######  ############# 
 #................................#  #.....#  #...........# 
 #................................#  #.....#  #...........# 
 #................................#  #.....#  #...........# 
 #................................#  #.....#  #...........# 
 #................................#  #.....#  #...........# 
 #................................#  #.....#  #...........# 
 #................................#  #.....#  #...........# 
 #................................#  #.....#  #...........# 
 #................................#  #.....#  #...........# 
 #................................#  #.....#  #...........# 
 ##################################  #.....#  #...........# 
                                     #.....#  #...........# 
                                     #.....#  #...........# 
 ##################################  #.....#  #...........# 
 #................................#  #.....#  #...........# 
 #................................#  #.....#  #...........# 
 #................................#  #.....#  #...........# 
 #................................#  #.....#  #...........# 
 #................................#  #.....#  #...........# 
 #................................#  #.....#  #...........# 
 #................................#  #.....#  #...........# 
 ##################################  #.....#  #...........# 
                                     #.....#  #...........# 
                                     #.....#  #...........# 
 ##########  #############  #######  #.....#  #...........# 
 #........#  #...........#  #.....#  #.....#  #...........# 
 #........#  #...........#  #.....#  #.....#  #...........# 
 #........#  #...........#  #.....#  #.....#  #...........# 
 #........#  #...........#  #.....#  #.....#  #...........# 
 ##########  #############  #######  #######  ############# 
                                                            
